EA ./images/east.xpm
NO ./images/north.xpm
WE ./images/west.xpm
SO ./images/south.xpm









F 43, 36, 36
C 55, 87, 140


        111111111111111111111111111111111111111111111111
        101000000011000000000000000000000000000000000001
        111100000111000000000000000000000000000000000001
        100100000000000000000000000000000000000000000001
11111111101100000111000000000000000000000000000000000001
10000E00001100000111011111111111111111111111111111111111
11110111111111111101110000001
11110111111111011101010010001
11000000110101011100000000001
10101000000000000000000000001
10000000000000000101000000001
1100000111010101111101000000111
11110111 1110101 101111010001
11111111 1111111 111111111111